1,2,3,4,5,X,X,X,X
6,5,4,3,2,1,X,X,X
1,2,3,4,5,6,1,X,X
6,5,4,3,2,1,6,5,X
1,2,3,4,5,6,1,2,3
X,6,5,4,3,2,1,6,5
X,X,1,2,3,4,5,6,1
X,X,X,6,5,4,3,2,1
X,X,X,X,1,2,3,4,5